-1 -1 -1 -1 -1 -1 -1 -1 -1 -1 -1 -1 -1 -1 -1 
-1 97 16 17 01 00 30 -1 00 00 00 00 00 97 -1  
-1 00 00 -1 00 -1 00 -1 00 43 00 -1 00 00 -1 
-1 05 00 -1 -1 -1 -1 00 00 04 -1 -1 00 00 -1 
-1 40 00 -1 00 -1 00 50 99 00 00 00 00 00 -1  
-1 78 00 77 00 00 00 00 -1 59 00 -1 -1 -1 -1 
-1 00 12 00 -1 00 77 46 00 00 39 00 35 00 -1 
-1 96 00 99 00 00 -1 00 00 00 00 00 -1 00 -1 
-1 00 -1 -1 00 -1 98 32 00 87 00 -1 98 00 -1 
-1 -1 -1 00 00 00 00 00 -1 00 -1 -1 -1 00 -1 
-1 97 00 00 00 00 00 00 -1 00 00 00 00 97 -1 
-1 -1 -1 -1 -1 -1 -1 -1 -1 -1 -1 -1 -1 -1 -1 