-1 -1 -1 -1 -1 -1 -1 -1 -1 -1 -1 -1 -1 -1 -1 
-1 97 00 00 00 00 00 -1 00 00 00 00 00 97 -1  
-1 00 00 -2 00 -2 00 -1 00 00 -2 -2 00 00 -1 
-1 00 00 -2 -2 -2 00 00 00 00 -2 -2 00 00 -1 
-1 00 00 -2 00 -2 00 00 99 00 00 00 00 00 -1  
-1 00 00 00 00 00 00 00 00 00 -3 -3 -3 -3 -1 
-1 00 00 00 -4 00 00 00 00 00 00 00 00 00 -1 
-1 96 00 99 00 00 -4 00 00 00 00 00 -4 00 -1 
-1 00 -1 -1 00 -4 98 00 00 00 00 -1 98 00 -1 
-1 -1 -1 00 00 00 00 00 -1 00 -1 -1 -1 00 -1 
-1 97 00 00 00 00 00 00 -1 00 00 00 00 97 -1 
-1 -1 -1 -1 -1 -1 -1 -1 -1 -1 -1 -1 -1 -1 -1 