-1 -1 -1 -1 -1 -1 -1 -1 -1 -1
-1 00 -1 01 02 03 04 05 06 -1
-1 07 -1 -1 -1 08 09 10 11 -1
-1 12 13 14 -1 15 -1 16 17 -1
-1 18 19 -1 -1 -1 -1 20 21 -1
-1 22 -1 -1 99 24 25 26 27 -1
-1 28 29 -1 98 -1 -1 -1 31 -1
-1 32 33 -1 -1 -1 97 -1 35 -1
-1 36 37 38 39 40 41 99 43 -1
-1 -1 -1 -1 -1 -1 -1 -1 -1 -1