-1 -1 -1 -1 -1 -1 -1 -1 -1 -1 -1 -1 -1 -1 -1 
-1 -1 97 00 00 00 00 -1 00 00 00 00 00 97 -1  
-1 00 -1 -4 00 00 00 04 00 00 00 00 00 00 -1 
-1 00 -1 -4 00 -4 00 00 -4 00 -2 -2 -2 00 -1 
-1 00 -1 -4 00 00 00 00 00 00 -2 -2 -2 98 -1  
-1 00 -1 -4 00 -1 -1 -1 -1 00 -2 -2 -2 00 -1 
-1 00 00 00 00 -1 -4 -4 -1 00 00 00 00 00 -1 
-1 00 -1 -1 00 -1 -4 -4 -1 00 99 00 00 00 -1 
-1 00 -1 00 00 -1 -1 -1 -1 00 00 -2 -2 -2 -1 
-1 98 -1 00 00 00 00 00 00 00 00 00 00 -1 -1 
-1 97 -1 99 00 00 -1 -2 -2 -2 -2 -2 97 -1 -1 
-1 -1 -1 -1 -1 -1 -1 -1 -1 -1 -1 -1 -1 -1 -1 
